,,,,,,,,,,,,,,,,,,,,,,,,,,,,,,,,,,,~~%%%%%%%%%%%%%%%%%%%%%%%%%%
,,,,,,,,,,,,,,,,,,,,,,,,,,,,,,,,,,,~~%%%%%%%%%%%%%%%%%%%%%%%%%%
,,,,,,,,,,,,,,,,,,,,,,,,,,,,,,,,,,~~~%%%%%%%%%%%%%%%%%%%%%%%%%%
,,,,,,,,,,,,,,,,,,,,,,,,,,,,,,,,,,~~~%%%%%%%%%%%%%%%%%%%%%%%%%%
,,,,,,,,,,,,,,###############,,,,~~~~%%%%%%%%%%%%%%%%%%%%%%%%%%
,,,,,,,,,,,,,##....#......#.##,,,~~~~%%%%%%%%%%%%%%%%%%%%%%%%%%
,,,,,,,,,,,,##.....#....../..##,,~~~~%%%%%%%%%%%%%%%%%%%%%%%%%%
,,,,,,,,,,,######/####+#########~~~~~%%%%%%%%%%%%%%%%%%%%%%%%%%
,,,,,,,,,,,#............#......#~~~~~%%%%%%%%%%%%%%%%%%%%%%%%%%
,,,,......./............+..>...#~~~~~%%%%%%%%%%%%%%%%%%%%%%%%%%
,,,,,,,,,,,#............#......#~~~~~%%%%%%%%%%%%%%%%%%%%%%%%%%
,,,,,,,,,,,####+######/##.....##~~~~~%%%%%%%%%%%%%%%%%%%%%%%%%%
,,,,,,,,,,,,##..........#....##~~~~~~%%%%%%%%%%%%%%%%%%%%%%%%%%
,,,,,,,,,,,,,##.........#...##~~~~~~~%%%%%%%%%%%%%%%%%%%%%%%%%%
,,,,,,,,,,,,,,###############~~~~~~~~%%%%%%%%%%%%%%%%%%%%%%%%%%
,,,,,,,,,,,,,,,~~~~~~~~~~~~~~~~~~~~~~%%%%%%%%%%%%%%%%%%%%%%%%%%
,,,,,,,,,,,,~~~~~~~~~~~~~~~~~~~~~~~~~%%%%%%%%%%%%%%%%%%%%%%%%%%
,,,,,,,~~~~~~~~~~~~~~~~~~~~~~~~~~~~~~%%%%%%%%%%%%%%%%%%%%%%%%%%
%%%%%%%%%%%%%%%%%%%%%%%%%%%%%%%%%%%%%%%%%%%%%%%%%%%%%%%%%%%%%%%
%%%%%%%%%%%%%%%%%%%%%%%%%%%%%%%%%%%%%%%%%%%%%%%%%%%%%%%%%%%%%%%
%%%%%%%%%%%%%%%%%%%%%%%%%%%%%%%%%%%%%%%%%%%%%%%%%%%%%%%%%%%%%%%
%%%%%%%%%%%%%%%%%%%%%%%%%%%%%%%%%%%%%%%%%%%%%%%%%%%%%%%%%%%%%%%
%%%%%%%%%%%%%%%%%%%%%%%%%%%%%%%%%%%%%%%%%%%%%%%%%%%%%%%%%%%%%%%
%%%%%%%%%%%%%%%%%%%%%%%%%%%%%%%%%%%%%%%%%%%%%%%%%%%%%%%%%%%%%%%
%%%%%%%%%%%%%%%%%%%%%%%%%%%%%%%%%%%%%%%%%%%%%%%%%%%%%%%%%%%%%%%
%%%%%%%%%%%%%%%%%%%%%%%%%%%%%%%%%%%%%%%%%%%%%%%%%%%%%%%%%%%%%%%
%%%%%%%%%%%%%%%%%%%%%%%%%%%%%%%%%%%%%%%%%%%%%%%%%%%%%%%%%%%%%%%
%%%%%%%%%%%%%%%%%%%%%%%%%%%%%%%%%%%%%%%%%%%%%%%%%%%%%%%%%%%%%%%
%%%%%%%%%%%%%%%%%%%%%%%%%%%%%%%%%%%%%%%%%%%%%%%%%%%%%%%%%%%%%%%
%%%%%%%%%%%%%%%%%%%%%%%%%%%%%%%%%%%%%%%%%%%%%%%%%%%%%%%%%%%%%%%
%%%%%%%%%%%%%%%%%%%%%%%%%%%%%%%%%%%%%%%%%%%%%%%%%%%%%%%%%%%%%%%
%%%%%%%%%%%%%%%%%%%%%%%%%%%%%%%%%%%%%%%%%%%%%%%%%%%%%%%%%%%%%%%
%%%%%%%%%%%%%%%%%%%%%%%%%%%%%%%%%%%%%%%%%%%%%%%%%%%%%%%%%%%%%%%
%%%%%%%%%%%%%%%%%%%%%%%%%%%%%%%%%%%%%%%%%%%%%%%%%%%%%%%%%%%%%%%
%%%%%%%%%%%%%%%%%%%%%%%%%%%%%%%%%%%%%%%%%%%%%%%%%%%%%%%%%%%%%%%
%%%%%%%%%%%%%%%%%%%%%%%%%%%%%%%%%%%%%%%%%%%%%%%%%%%%%%%%%%%%%%%
%%%%%%%%%%%%%%%%%%%%%%%%%%%%%%%%%%%%%%%%%%%%%%%%%%%%%%%%%%%%%%%
%%%%%%%%%%%%%%%%%%%%%%%%%%%%%%%%%%%%%%%%%%%%%%%%%%%%%%%%%%%%%%%
%%%%%%%%%%%%%%%%%%%%%%%%%%%%%%%%%%%%%%%%%%%%%%%%%%%%%%%%%%%%%%%
%%%%%%%%%%%%%%%%%%%%%%%%%%%%%%%%%%%%%%%%%%%%%%%%%%%%%%%%%%%%%%%
%%%%%%%%%%%%%%%%%%%%%%%%%%%%%%%%%%%%%%%%%%%%%%%%%%%%%%%%%%%%%%%
%%%%%%%%%%%%%%%%%%%%%%%%%%%%%%%%%%%%%%%%%%%%%%%%%%%%%%%%%%%%%%%
%%%%%%%%%%%%%%%%%%%%%%%%%%%%%%%%%%%%%%%%%%%%%%%%%%%%%%%%%%%%%%%
%%%%%%%%%%%%%%%%%%%%%%%%%%%%%%%%%%%%%%%%%%%%%%%%%%%%%%%%%%%%%%%
%%%%%%%%%%%%%%%%%%%%%%%%%%%%%%%%%%%%%%%%%%%%%%%%%%%%%%%%%%%%%%%
%%%%%%%%%%%%%%%%%%%%%%%%%%%%%%%%%%%%%%%%%%%%%%%%%%%%%%%%%%%%%%%
%%%%%%%%%%%%%%%%%%%%%%%%%%%%%%%%%%%%%%%%%%%%%%%%%%%%%%%%%%%%%%%
